новая   квартира, appartamento nuovo
удобный стул,     sedia        comoda
старая  кухня,    cucina       vecchia
тихий   район,    quartiere    tranquillo

Это слишком маленькие комнаты! Sono stanze troppo piccole!
В квартире красивые шкафы.     Nell'appartamento (ci sono) degli armadi belli.
Какие шумные соседи!           Che vicini rumorosi!
В городе высокие дома.         In città (ci sono) delle case alte.

ноутбук   = notebook
картина   = dipinto
телевизор = televisore
книга     = libro

Это кошка соседки    = Questo è il gatto  della vicina. "forma-avere-strano"
Это жена  соседа     = Questa è la moglie del   vicino. "forma-avere-strano"
Чей это   велосипед? = Di chi è questa bicicletta ?
Чья это   машина?    = Di chi è questa macchina   ?

начинается = inizia
час        = ora
концерт    = concerto
спектакль  = spettacolo

Вечером мы будем в кино         = Di sera saremo al cinema.
Ты         будешь сегодня дома? = Sarai a casa oggi?
Завтра     будет холодно        = Domani sarà freddo
Когда      будет тепло?         = Quando sarà caldo?

не      работает = non funziona
Большое спасибо  = grazie molte (mille/beaucoup)

сыр    = formaggio
курица = pollo
вода   = acqua
хлеб   = pane